21 21
211111111111111111112
100000000100000000001
100000000100000000001
111100000100000111111
100000000000000000001
100000000000000000001
101111100000011111011
100000100000010000011
100000100344010000011
100000100000010000011
101111100000011111011
100000000000000000001
100000000000000000001
111100000100000111111
100000000100000000001
100000000100000000001
100000000000000000001
100000000000000000001
100000000000000000001
100000000000000000001
211111111111111111112
