21 21
211111111111111111112
100000000000000000001
100000000000000000001
100000000000000000001
100011100000011100001
100010000000000100001
100010000000000100001
100010000000000100001
100010000344000100001
100010000000000100001
100010000000000100001
100010000000000100001
100011100000011100001
100000000000000000001
100000000000000000001
100000000000000000001
100000000000000000001
100000000000000000001
100000000000000000001
100000000000000000001
211111111111111111112
